"filename", "language", "Markdown", "HTML", "JSON", "CSS", "JavaScript", "comment", "blank", "total"
"d:\vsworkspace\vsworkspace\README.md", "Markdown", 1, 0, 0, 0, 0, 0, 1, 2
"d:\vsworkspace\第七周\01第一天\01-js函数定义.html", "HTML", 0, -30, 0, 0, 0, -1, -11, -42
"d:\vsworkspace\第七周\01第一天\02-函数调用.html", "HTML", 0, -28, 0, 0, 0, 0, -6, -34
"d:\vsworkspace\第七周\01第一天\03-函数使用细节.html", "HTML", 0, -36, 0, 0, 0, 0, -9, -45
"d:\vsworkspace\第七周\01第一天\04-函数返回值.html", "HTML", 0, -38, 0, 0, 0, 0, -16, -54
"d:\vsworkspace\第七周\01第一天\05-函数联系.html", "HTML", 0, -28, 0, 0, 0, 0, -13, -41
"d:\vsworkspace\第七周\01第一天\06-函数递归.html", "HTML", 0, -51, 0, 0, 0, 0, -7, -58
"d:\vsworkspace\第七周\01第一天\07-变量作用域.html", "HTML", 0, -27, 0, 0, 0, 0, -8, -35
"d:\vsworkspace\第七周\01第一天\08-let和var定义变量.html", "HTML", 0, -33, 0, 0, 0, 0, -2, -35
"d:\vsworkspace\第七周\01第一天\09-全局函数.html", "HTML", 0, -49, 0, 0, 0, 0, -17, -66
"d:\vsworkspace\第七周\01第一天\10-数组.html", "HTML", 0, -32, 0, 0, 0, 0, -7, -39
"d:\vsworkspace\第七周\01第一天\11-基于下标的数组操作.html", "HTML", 0, -44, 0, 0, 0, 0, -14, -58
"d:\vsworkspace\第七周\01第一天\12-数组的方法.html", "HTML", 0, -46, 0, 0, 0, 0, -11, -57
"d:\vsworkspace\第七周\01第一天\homework01.html", "HTML", 0, -27, 0, 0, 0, 0, -7, -34
"d:\vsworkspace\第七周\01第一天\homework02.html", "HTML", 0, -22, 0, 0, 0, 0, -5, -27
"d:\vsworkspace\第七周\01第一天\homework03.html", "HTML", 0, -77, 0, 0, 0, 0, -39, -116
"d:\vsworkspace\第七周\02第二天\01-BOM对象.html", "HTML", 0, -63, 0, 0, 0, 0, -11, -74
"d:\vsworkspace\第七周\02第二天\02-定时器.html", "HTML", 0, -45, 0, 0, 0, 0, -16, -61
"d:\vsworkspace\第七周\02第二天\03-随机点名.html", "HTML", 0, -16, 0, 0, 0, 0, -5, -21
"d:\vsworkspace\第七周\02第二天\04-其他的BOM对象.html", "HTML", 0, -29, 0, 0, 0, 0, -5, -34
"d:\vsworkspace\第七周\02第二天\05-history.html", "HTML", 0, -23, 0, 0, 0, 0, -4, -27
"d:\vsworkspace\第七周\02第二天\06-document.html", "HTML", 0, -58, 0, 0, 0, 0, -22, -80
"d:\vsworkspace\第七周\02第二天\07-dom的添加修改删除操作.html", "HTML", 0, -70, 0, 0, 0, 0, -21, -91
"d:\vsworkspace\第七周\02第二天\08-dom中的属性介绍.html", "HTML", 0, -29, 0, 0, 0, 0, -4, -33
"d:\vsworkspace\第七周\02第二天\09-js操作样式.html", "HTML", 0, -60, 0, 0, 0, 0, -8, -68
"d:\vsworkspace\第七周\02第二天\10-dom练习.html", "HTML", 0, -93, 0, 0, 0, 0, -18, -111
"d:\vsworkspace\第七周\02第二天\11-demo练习.html", "HTML", 0, -62, 0, 0, 0, 0, -11, -73
"d:\vsworkspace\第七周\02第二天\12-进度条.html", "HTML", 0, -41, 0, 0, 0, 0, -18, -59
"d:\vsworkspace\第七周\02第二天\fonts\iconfont.css", "CSS", 0, 0, 0, -28, 0, 0, -8, -36
"d:\vsworkspace\第七周\02第二天\fonts\iconfont.js", "JavaScript", 0, 0, 0, 0, -1, 0, 0, -1
"d:\vsworkspace\第七周\02第二天\fonts\iconfont.json", "JSON", 0, 0, -44, 0, 0, 0, -1, -45
"d:\vsworkspace\第七周\02第二天\homework01.html", "HTML", 0, -32, 0, 0, 0, 0, -6, -38
"d:\vsworkspace\第七周\02第二天\homework02.html", "HTML", 0, -25, 0, 0, 0, 0, -6, -31
"d:\vsworkspace\第七周\02第二天\homework03.html", "HTML", 0, -15, 0, 0, 0, 0, -6, -21
"d:\vsworkspace\第七周\03第三天\01-js中的属性操作.html", "HTML", 0, -32, 0, 0, 0, 0, -7, -39
"d:\vsworkspace\第七周\03第三天\02-自定义属性练习.html", "HTML", 0, -34, 0, 0, 0, 0, -6, -40
"d:\vsworkspace\第七周\03第三天\03-事件的绑定方式.html", "HTML", 0, -54, 0, 0, 0, -8, -6, -68
"d:\vsworkspace\第七周\03第三天\04-通过标签对象绑定事件.html", "HTML", 0, -56, 0, 0, 0, -1, -4, -61
"d:\vsworkspace\第七周\03第三天\05-通过标准模式绑定事件.html", "HTML", 0, -63, 0, 0, 0, -1, -7, -71
"d:\vsworkspace\第七周\03第三天\06-鼠标事件.html", "HTML", 0, -44, 0, 0, 0, 0, -9, -53
"d:\vsworkspace\第七周\03第三天\07-键盘事件.html", "HTML", 0, -49, 0, 0, 0, 0, -7, -56
"d:\vsworkspace\第七周\03第三天\08-表单事件.html", "HTML", 0, -40, 0, 0, 0, -22, -9, -71
"d:\vsworkspace\第七周\03第三天\09-input事件.html", "HTML", 0, -39, 0, 0, 0, -3, -3, -45
"d:\vsworkspace\第七周\03第三天\10-课堂练习.html", "HTML", 0, -22, 0, 0, 0, 0, -5, -27
"d:\vsworkspace\第七周\03第三天\12-窗口事件.html", "HTML", 0, -39, 0, 0, 0, 0, -5, -44
"d:\vsworkspace\第七周\03第三天\13-事件处理机制.html", "HTML", 0, -65, 0, 0, 0, 0, -10, -75
"d:\vsworkspace\第七周\03第三天\14-事件委派.html", "HTML", 0, -42, 0, 0, 0, 0, -8, -50
"d:\vsworkspace\第七周\03第三天\15-事件返回值.html", "HTML", 0, -24, 0, 0, 0, 0, 0, -24
"d:\vsworkspace\第七周\03第三天\16-web存储.html", "HTML", 0, -50, 0, 0, 0, 0, -11, -61
"d:\vsworkspace\第七周\03第三天\17-json.html", "HTML", 0, -26, 0, 0, 0, -1, -1, -28
"d:\vsworkspace\第七周\03第三天\homework01.html", "HTML", 0, -50, 0, 0, 0, -2, -13, -65
"d:\vsworkspace\第七周\03第三天\homework02 copy.html", "HTML", 0, -155, 0, 0, 0, -1, -20, -176
"d:\vsworkspace\第七周\03第三天\homework02.html", "HTML", 0, -169, 0, 0, 0, -1, -31, -201
"d:\vsworkspace\第七周\04第四天\01-结构赋值.html", "HTML", 0, -43, 0, 0, 0, 0, -15, -58
"d:\vsworkspace\第七周\04第四天\02-展开运算符.html", "HTML", 0, -63, 0, 0, 0, 0, -13, -76
"d:\vsworkspace\第七周\04第四天\03-模板字符串.html", "HTML", 0, -27, 0, 0, 0, 0, -3, -30
"d:\vsworkspace\第七周\04第四天\04-对象简写.html", "HTML", 0, -43, 0, 0, 0, 0, -6, -49
"d:\vsworkspace\第七周\04第四天\05-类.html", "HTML", 0, -50, 0, 0, 0, 0, -8, -58
"d:\vsworkspace\第七周\04第四天\06-练习.html", "HTML", 0, -25, 0, 0, 0, 0, -4, -29
"Total", "-", 1, -2533, -44, -28, -1, -41, -552, -3198